abot	adjektiva
adigung	adjektiva
aduh	adjektiva
agamana	adjektiva
ageung	adjektiva
agul	adjektiva
agung	adjektiva
ahir-ahir	adjektiva
ahirna	adjektiva
ahlak	adjektiva
ajenan	adjektiva
akar-akarna	adjektiva
alanyar	adjektiva
aleman	adjektiva
alesanana	adjektiva
alit	adjektiva
alum	adjektiva
alus	adjektiva
aman	adjektiva
amis	adjektiva
ampeg	adjektiva
anggang	adjektiva
angker	adjektiva
angluh	adjektiva
anyar	adjektiva
apek	adjektiva
arang	adjektiva
arum	adjektiva
asak	adjektiva
asin	adjektiva
atah	adjektiva
ateul	adjektiva
atoh	adjektiva
atra	adjektiva
aub	adjektiva
auh	adjektiva
awet	adjektiva
awis	adjektiva
awon	adjektiva
ayaan	adjektiva
baal	adjektiva
babari	adjektiva
babu	adjektiva
bacin	adjektiva
badag	adjektiva
badegong	adjektiva
badeolan	adjektiva
bagedur	adjektiva
bageur	adjektiva
bahaya	adjektiva
balilu	adjektiva
bangga	adjektiva
bangir	adjektiva
bangor	adjektiva
baong	adjektiva
bareuh	adjektiva
baribin	adjektiva
basa	adjektiva
baseuh	adjektiva
batan	adjektiva
bayuhyuh	adjektiva
bedegong	adjektiva
begang	adjektiva
belegug	adjektiva
belemo	adjektiva
belengep	adjektiva
beler	adjektiva
belet	adjektiva
belok	adjektiva
bener	adjektiva
bera	adjektiva
bersih	adjektiva
betot	adjektiva
beueus	adjektiva
beuleum	adjektiva
beunghar	adjektiva
beurat	adjektiva
beureum	adjektiva
biasa	adjektiva
biko	adjektiva
bingah	adjektiva
bingung	adjektiva
bitan	adjektiva
bobot	adjektiva
bocokok	adjektiva
bodas	adjektiva
bodo	adjektiva
bohak	adjektiva
bonto	adjektiva
bopeng	adjektiva
borangan	adjektiva
boek	adjektiva
bujeng	adjektiva
bulao	adjektiva
buleud	adjektiva
buligir	adjektiva
bungah	adjektiva
buntut	adjektiva
bureuteu	adjektiva
burey	adjektiva
buruk	adjektiva
buyatak	adjektiva
bear	adjektiva
bebas	adjektiva
becek	adjektiva
beda	adjektiva
berehan	adjektiva
berendel	adjektiva
caang	adjektiva
cacad	adjektiva
cacap	adjektiva
cadel	adjektiva
cageur	adjektiva
caket	adjektiva
calakan	adjektiva
caliweura	adjektiva
cangcaya	adjektiva
cape	adjektiva
cekap	adjektiva
cekip	adjektiva
celi	adjektiva
cerah	adjektiva
ceuceub	adjektiva
ceumeung	adjektiva
combrek	adjektiva
comro	adjektiva
curang	adjektiva
damang	adjektiva
dangka	adjektiva
darapon	adjektiva
daria	adjektiva
datar	adjektiva
demplon	adjektiva
depa	adjektiva
deuheus	adjektiva
deukeut	adjektiva
donto	adjektiva
dorong	adjektiva
deoh	adjektiva
deet	adjektiva
efisien	adjektiva
egois	adjektiva
eutik	adjektiva
gagah	adjektiva
gampang	adjektiva
gampil	adjektiva
gancang	adjektiva
gandeng	adjektiva
ganep	adjektiva
gangsal	adjektiva
garok	adjektiva
gaya	adjektiva
geblah-gebloh	adjektiva
gebloh	adjektiva
gede	adjektiva
gegetun	adjektiva
gelo	adjektiva
gemboy	adjektiva
getol	adjektiva
geuleuh	adjektiva
geulis	adjektiva
gimbir	adjektiva
ginding	adjektiva
giruk	adjektiva
goreng	adjektiva
gumbira	adjektiva
gumira	adjektiva
gurih	adjektiva
gelo	adjektiva
hade	adjektiva
halabhab	adjektiva
haleungheum	adjektiva
hampang	adjektiva
hanaang	adjektiva
handap	adjektiva
handaruan	adjektiva
handeueul	adjektiva
haneut	adjektiva
hangseur	adjektiva
hanjakal	adjektiva
hanyir	adjektiva
haratis	adjektiva
hareeng	adjektiva
hareudang	adjektiva
hariwang	adjektiva
harua	adjektiva
harum	adjektiva
haseum	adjektiva
hawatir	adjektiva
hawatos	adjektiva
hawek	adjektiva
hejo	adjektiva
heubeul	adjektiva
heuras	adjektiva
heureut	adjektiva
heurin	adjektiva
hideung	adjektiva
hipu	adjektiva
hirup	adjektiva
honeng	adjektiva
hoream	adjektiva
hulap	adjektiva
hurip	adjektiva
hegar	adjektiva
hejo	adjektiva
hengker	adjektiva
herang	adjektiva
hese	adjektiva
ijid	adjektiva
indung	adjektiva
ipis	adjektiva
isin	adjektiva
iuh	adjektiva
jangkep	adjektiva
janglar	adjektiva
jauh	adjektiva
jeblog	adjektiva
jebrog	adjektiva
jeding	adjektiva
jegu	adjektiva
jembar	adjektiva
jempling	adjektiva
jengil	adjektiva
jengker	adjektiva
jenuk	adjektiva
jiji	adjektiva
jumeneng	adjektiva
kabintrang	adjektiva
kaciri	adjektiva
kadeuleu	adjektiva
kaduhung	adjektiva
kagok	adjektiva
kagum	adjektiva
kaguyuban	adjektiva
kaget	adjektiva
kakandungan	adjektiva
kambuy	adjektiva
kandel	adjektiva
kapok	adjektiva
karangsang	adjektiva
karesep	adjektiva
kareueut	adjektiva
kari	adjektiva
kasep	adjektiva
kasep	adjektiva
katara	adjektiva
katawis	adjektiva
kateken	adjektiva
katempo	adjektiva
katingal	adjektiva
katingali	adjektiva
kayas	adjektiva
kebel	adjektiva
kejem	adjektiva
kejeng	adjektiva
keuheul	adjektiva
kiat	adjektiva
kirang	adjektiva
kiwa	adjektiva
kodol	adjektiva
kokoro	adjektiva
koneng	adjektiva
koret	adjektiva
kuat	adjektiva
kuciwa	adjektiva
kulawu	adjektiva
kumed	adjektiva
kuna	adjektiva
kuru	adjektiva
kede	adjektiva
kenca	adjektiva
lada	adjektiva
lalawora	adjektiva
lali	adjektiva
lami	adjektiva
lamokot	adjektiva
lamur	adjektiva
lana	adjektiva
langki	adjektiva
langkung	adjektiva
langsip	adjektiva
larangan	adjektiva
laris	adjektiva
laun	adjektiva
layu	adjektiva
laer	adjektiva
lebet	adjektiva
ledok	adjektiva
legih	adjektiva
lembut	adjektiva
lemes	adjektiva
lengkep	adjektiva
lenyah	adjektiva
lepat	adjektiva
leres	adjektiva
leueur	adjektiva
leuit	adjektiva
leukleuk	adjektiva
leuleus	adjektiva
leutik	adjektiva
leuwih	adjektiva
licik	adjektiva
lieur	adjektiva
lila	adjektiva
limpeuran	adjektiva
lindeuk	adjektiva
linghas	adjektiva
lingsem	adjektiva
liwung	adjektiva
loba	adjektiva
logor	adjektiva
lojor	adjektiva
lolong	adjektiva
lucu	adjektiva
luis	adjektiva
lungse	adjektiva
lengle	adjektiva
lesang	adjektiva
mahal	adjektiva
mahi	adjektiva
mamajeng	adjektiva
mamayu	adjektiva
mencos	adjektiva
mending	adjektiva
mengi	adjektiva
merenah	adjektiva
mindeng	adjektiva
mintul	adjektiva
mirah	adjektiva
miwarang	adjektiva
motekar	adjektiva
murah	adjektiva
muriang	adjektiva
menel	adjektiva
ngaruksak	adjektiva
ngeunah	adjektiva
ngora	adjektiva
nyaan	adjektiva
nyalira	adjektiva
nyangu	adjektiva
nyenyepan	adjektiva
ompong	adjektiva
pabalatak	adjektiva
pageto	adjektiva
pahang	adjektiva
pait	adjektiva
palay	adjektiva
palay ngaleueut	adjektiva
pamungkas	adjektiva
panas	adjektiva
panjang	adjektiva
paos	adjektiva
pareum	adjektiva
parna	adjektiva
parek	adjektiva
paturay	adjektiva
payu	adjektiva
pedit	adjektiva
pegat	adjektiva
pejet	adjektiva
peka	adjektiva
pelik	adjektiva
perceka	adjektiva
peuyeuh	adjektiva
pias	adjektiva
pinter	adjektiva
pinuh	adjektiva
polos	adjektiva
poek	adjektiva
pribadi	adjektiva
pribados	adjektiva
pucet	adjektiva
pundung	adjektiva
pundungan	adjektiva
pupulasan	adjektiva
puyeng	adjektiva
peot	adjektiva
rajin	adjektiva
rame	adjektiva
rangu	adjektiva
ranyedan	adjektiva
raos	adjektiva
rapih	adjektiva
rayungan	adjektiva
rejag	adjektiva
reksak	adjektiva
rempug	adjektiva
renyem	adjektiva
reueus	adjektiva
reugreug	adjektiva
reuneuh	adjektiva
reuwas	adjektiva
risi	adjektiva
riweuh	adjektiva
roges	adjektiva
rubak	adjektiva
rugel	adjektiva
rugi	adjektiva
ruksak	adjektiva
rungkad	adjektiva
rupit	adjektiva
rea	adjektiva
rencangna	adjektiva
rentek	adjektiva
saalit	adjektiva
sadar	adjektiva
sadrah	adjektiva
saemet	adjektiva
saeutik	adjektiva
sakedik	adjektiva
salah	adjektiva
sampurna	adjektiva
sangheuk	adjektiva
sapat	adjektiva
sareukseuk	adjektiva
sarua	adjektiva
saruana	adjektiva
sarupa	adjektiva
satia	adjektiva
sae	adjektiva
sedek	adjektiva
sedih	adjektiva
sepa	adjektiva
sepah	adjektiva
serak	adjektiva
sereg	adjektiva
nyeri	adjektiva
sesah	adjektiva
seueur	adjektiva
seuhah	adjektiva
seukeut	adjektiva
seungit	adjektiva
siap	adjektiva
sibuk	adjektiva
sieun	adjektiva
sirik	adjektiva
sok	adjektiva
sologoto	adjektiva
sompral	adjektiva
sono	adjektiva
sopan	adjektiva
sorangan	adjektiva
sukur	adjektiva
sungkawa	adjektiva
suranyeh	adjektiva
susah	adjektiva
sejen	adjektiva
takut	adjektiva
taliti	adjektiva
tangtu	adjektiva
tarahal	adjektiva
taranjang	adjektiva
tarik	adjektiva
tegas	adjektiva
teges	adjektiva
telat	adjektiva
telik	adjektiva
temaha	adjektiva
tenang	adjektiva
tetep	adjektiva
teu kosi	adjektiva
teu ningal	adjektiva
teu ningali	adjektiva
teunangan	adjektiva
tidur	adjektiva
tiis	adjektiva
timburu	adjektiva
timus	adjektiva
tiris	adjektiva
toblo	adjektiva
tohaga	adjektiva
tumut	adjektiva
tenar	adjektiva
untung	adjektiva
utama	adjektiva
utami	adjektiva
wadul	adjektiva
wales	adjektiva
wandu	adjektiva
wangi	adjektiva
wani	adjektiva
wantun	adjektiva
waspada	adjektiva
waspaos	adjektiva
wedel	adjektiva
werat	adjektiva
weuteuh	adjektiva
wijaksana	adjektiva
wingit	adjektiva
wuwuda	adjektiva
yakin	adjektiva
yakti	adjektiva
yaktos	adjektiva
emut	adjektiva
enak	adjektiva
endah	adjektiva
era	adjektiva
aim	adverbia
ajalna	adverbia
akalna	adverbia
akibatna	adverbia
aksarana	adverbia
alakur	adverbia
alamatna	adverbia
alim	adverbia
ampir	adverbia
angger	adverbia
anggeus	adverbia
arek	adverbia
arek	adverbia
asa	adverbia
atos	adverbia
ayeuna	adverbia
babaneh	adverbia
babasan	adverbia
bade	adverbia
baheula	adverbia
baku	adverbia
bareng	adverbia
bari	adverbia
bareto	adverbia
bentet	adverbia
bieu	adverbia
bieung	adverbia
bilih	adverbia
boro-boro	adverbia
carek	adverbia
doang	adverbia
duka	adverbia
dung	adverbia
embung	adverbia
emong	adverbia
endung	adverbia
enggeus	adverbia
enging	adverbia
engke	adverbia
entos	adverbia
eurih	adverbia
ganteng	adverbia
gelaran	adverbia
geus	adverbia
goblog	adverbia
gen	adverbia
genan	adverbia
hayang	adverbia
henteu	adverbia
heula	adverbia
hogan	adverbia
hoyong	adverbia
ilok	adverbia
isukan	adverbia
isuk	adverbia
jasa	adverbia
kacida	adverbia
kadua	adverbia
kalintang	adverbia
kanjat	adverbia
kantun	adverbia
karak	adverbia
karek	adverbia
kari	adverbia
karek	adverbia
keding	adverbia
kirang	adverbia
kirang terang	adverbia
kosong	adverbia
kudu	adverbia
keneh	adverbia
lain	adverbia
lamari	adverbia
lapar	adverbia
lekasan	adverbia
lohor	adverbia
maenya	adverbia
mananten	adverbia
manawa	adverbia
manawi	adverbia
meureun	adverbia
minangka	adverbia
minangki	adverbia
narah	adverbia
ndeuk	adverbia
nembe	adverbia
nu	adverbia
nyao	adverbia
oge	adverbia
palay	adverbia
pamugi	adverbia
pan	adverbia
pang	adverbia
panginten	adverbia
parantos	adverbia
percaya diri	adverbia
pira ku teuing	adverbia
piraku	adverbia
pisan	adverbia
puguh	adverbia
puhung	adverbia
rieut	adverbia
riweuh	adverbia
rengse	adverbia
sabar	adverbia
sanes	adverbia
sareng	adverbia
seja	adverbia
sesek	adverbia
seubeuh	adverbia
sugan	adverbia
sehat	adverbia
sewang-sewang	adverbia
tara	adverbia
terang-terang	adverbia
teu	adverbia
teu kersa	adverbia
teu kenging	adverbia
teu sudi	adverbia
teudeuk	adverbia
teuing	adverbia
timpang	adverbia
tos	adverbia
tulus	adverbia
tutup	adverbia
ugi	adverbia
ujug-ujug	adverbia
ujur	adverbia
ulah	adverbia
umum	adverbia
wareg	adverbia
ek	adverbia
enggal	adverbia
enjing	adverbia
pun	artikula
sakadang	artikula
si	artikula
tuang	artikula
baraha	interogativa
iraha	interogativa
kapan	interogativa
kuma	interogativa
kumaha	interogativa
kunaeun	interogativa
kunaha	interogativa
kunaon	interogativa
kenging naha	interogativa
manten	interogativa
naeun	interogativa
naha	interogativa
nahaon	interogativa
naon	interogativa
pan	interogativa
pira	interogativa
sapertos kumaha	interogativa
sapertos manten	interogativa
baraha	konjungsi
iraha	konjungsi
kapan	konjungsi
kuma	konjungsi
kumaha	konjungsi
kunaeun	konjungsi
kunaha	konjungsi
kunaon	konjungsi
kenging naha	konjungsi
manten	konjungsi
naeun	konjungsi
naha	konjungsi
nahaon	konjungsi
naon	konjungsi
pan	konjungsi
pira	konjungsi
sapertos kumaha	konjungsi
sapertos manten	konjungsi
aanjangan	nomina
abah	nomina
aben	nomina
abir	nomina
acay	nomina
aceuk	nomina
aci	nomina
acin	nomina
acing	nomina
acis	nomina
acuk	nomina
adat	nomina
adi	nomina
adi beuteung	nomina
adonan-adonan	nomina
adonanana	nomina
adu	nomina
ade	nomina
agami	nomina
Ahad	nomina
ajag	nomina
ajeng	nomina
ajengan	nomina
akang	nomina
akangna	nomina
akar	nomina
akarna	nomina
aki	nomina
alasna	nomina
ali	nomina
almenak	nomina
alo	nomina
ama	nomina
amang	nomina
ambu	nomina
amparan	nomina
ancu	nomina
angen	nomina
angeun	nomina
anggel	nomina
anggoan	nomina
anggrid	nomina
angin	nomina
angkeut	nomina
angklung	nomina
angkeng	nomina
angsulan	nomina
anjun	nomina
areng	nomina
arep	nomina
artos	nomina
aseup	nomina
asma	nomina
astana	nomina
ati	nomina
awak	nomina
awan	nomina
awi	nomina
awewe	nomina
awewena	nomina
awewenya	nomina
baal	nomina
babajeg	nomina
babakan	nomina
babalung	nomina
babatok	nomina
babaturan	nomina
babi	nomina
babon	nomina
bacot	nomina
badak	nomina
badog	nomina
badut	nomina
baga	nomina
bagbagan	nomina
bagedor	nomina
bagong	nomina
bagean	nomina
baham	nomina
bahayu	nomina
bajetah	nomina
bajigur	nomina
baju	nomina
bajeg	nomina
bako	nomina
bakti	nomina
baktos	nomina
bal	nomina
bala-bala	nomina
balabur	nomina
balangsiar	nomina
balarea	nomina
balay	nomina
balong	nomina
balukang	nomina
banawasa	nomina
banci	nomina
bandot	nomina
bandera	nomina
bangbung	nomina
bangkong	nomina
bangkuang	nomina
bangsar	nomina
bangus	nomina
bantal	nomina
bapa	nomina
baranahan	nomina
baraya	nomina
bari	nomina
baros	nomina
barudak	nomina
baruncing	nomina
bas	nomina
basantara	nomina
basantawis	nomina
basilat	nomina
baso	nomina
bati	nomina
batik	nomina
batu	nomina
batuk	nomina
batur	nomina
baturna	nomina
bayah	nomina
bayawak	nomina
bayongbong	nomina
bebegug	nomina
bebek	nomina
bebel	nomina
bebendul	nomina
bebengok	nomina
bebenguk	nomina
bebodoran	nomina
becek	nomina
becus	nomina
bedog	nomina
bedul	nomina
bekok	nomina
belis	nomina
belul	nomina
bendo	nomina
bengangun	nomina
beubeur	nomina
beuheula	nomina
beuheung	nomina
beuheung pianakan	nomina
beulah	nomina
beulitan	nomina
beungeut	nomina
beungkeut	nomina
beurang	nomina
beurit	nomina
beusi	nomina
beuteung	nomina
biang	nomina
bibi	nomina
bihari	nomina
bijanggut	nomina
bikang	nomina
bilatung	nomina
bilik	nomina
binih	nomina
binihna	nomina
bintang	nomina
birit	nomina
biruang	nomina
bisa	nomina
bisul	nomina
biwir	nomina
bo'ol	nomina
boa	nomina
bobocos	nomina
bobotoh	nomina
bodin	nomina
bodor	nomina
bojo	nomina
bolor	nomina
bondoroyot	nomina
bool	nomina
bray	nomina
buah	nomina
bubukuan	nomina
bubuyut	nomina
budah	nomina
budak	nomina
buduk	nomina
bujal	nomina
bujangga	nomina
bujur	nomina
buktos	nomina
bulan	nomina
bulu	nomina
bulu hayam	nomina
bumbu	nomina
bumi	nomina
bungur	nomina
bupati	nomina
bupatos	nomina
burayot	nomina
buri	nomina
burih	nomina
buruan	nomina
buruy	nomina
buuk	nomina
buyur	nomina
beas	nomina
bebeakan	nomina
bebeja	nomina
bebene	nomina
beja	nomina
bentang	nomina
besan	nomina
bewara	nomina
caang	nomina
caang sasih	nomina
cabe	nomina
cacaka	nomina
cacangkir	nomina
cagak	nomina
cai	nomina
caing	nomina
cak	nomina
cakcak	nomina
calacah	nomina
calana	nomina
calon	nomina
calung	nomina
cangkeng	nomina
cangreud	nomina
cantigi	nomina
caratan	nomina
caringin	nomina
caroge	nomina
carecet	nomina
cawene	nomina
cempor	nomina
cengek	nomina
cepil	nomina
ceuhay	nomina
ceuli	nomina
ceunah	nomina
ci	nomina
cicis	nomina
ciduh	nomina
cikahampangan	nomina
cikiih	nomina
cileuh	nomina
cingcin	nomina
cinggir	nomina
cipapang	nomina
cocooan	nomina
cokor	nomina
coleng	nomina
comro	nomina
corob	nomina
cucuk	nomina
cucungik	nomina
cucunguk	nomina
cunduk rahayu	nomina
cungcurungan	nomina
cungur	nomina
cupat manggu	nomina
curug	nomina
curuk	nomina
ceker	nomina
dada	nomina
daging	nomina
dahan	nomina
dalapan belas	nomina
damis	nomina
dampal	nomina
dampal sampean	nomina
dampal suku	nomina
danas	nomina
dangdeur	nomina
danget	nomina
danget ieu	nomina
darma	nomina
darmamurcaya	nomina
dasar	nomina
datu	nomina
daun	nomina
dawuh	nomina
deku	nomina
detik	nomina
deudeuh	nomina
dinten	nomina
dite	nomina
dodonges	nomina
doger	nomina
domba	nomina
dora	nomina
dua belas	nomina
dua puluh hiji	nomina
dudukuy	nomina
duit	nomina
dukuh	nomina
dulur	nomina
dunungan	nomina
duriat	nomina
duruk	nomina
dede	nomina
dehe	nomina
ema	nomina
emang	nomina
embe	nomina
ember	nomina
embe	nomina
emeng	nomina
endog	nomina
eneng	nomina
enggon	nomina
engkang	nomina
engkin	nomina
enin	nomina
enteh	nomina
enen	nomina
eukeur	nomina
eunteung	nomina
eureup-eureup	nomina
gaang	nomina
gado	nomina
gajah	nomina
gajih	nomina
galih	nomina
galing	nomina
gambuh	nomina
gamparan	nomina
ganas	nomina
gandul	nomina
garila	nomina
garwa	nomina
gawir	nomina
gedang	nomina
gedong	nomina
gegeber	nomina
gegebing	nomina
gegembung	nomina
gelam	nomina
gelap	nomina
gending	nomina
gendul	nomina
genep belas	nomina
genggerong	nomina
geni	nomina
gentra	nomina
getih	nomina
geubis	nomina
geulang	nomina
geureuha	nomina
giwang	nomina
goah	nomina
gobang	nomina
goblok	nomina
godin	nomina
gogobrog	nomina
gogodoh	nomina
gogog	nomina
gohgoy	nomina
gong	nomina
gori	nomina
gunung	nomina
gendot	nomina
hakaneun	nomina
haleuang	nomina
haleungheum	nomina
halimun	nomina
halis	nomina
hampas	nomina
hamperu	nomina
hanca	nomina
hancengan	nomina
hapunten	nomina
haregu	nomina
hareup	nomina
hareupcatra	nomina
harga	nomina
hargi	nomina
harigu	nomina
harti	nomina
hartos	nomina
haruman	nomina
haseup	nomina
hateup	nomina
hatur nuhun	nomina
hate	nomina
hawu	nomina
hayam	nomina
hejo	nomina
helaran	nomina
heunceut	nomina
heureuy	nomina
hideng	nomina
hihid	nomina
hileud	nomina
hitut	nomina
honje	nomina
hui	nomina
hui kumeli	nomina
huis	nomina
hulu	nomina
huma	nomina
huntu	nomina
huru bodas	nomina
hutang	nomina
Hyang	nomina
hejo	nomina
hendep	nomina
iasa	nomina
ibu	nomina
ihtiar	nomina
ilat	nomina
iler	nomina
imah	nomina
imbit	nomina
impi	nomina
impen	nomina
inang	nomina
incu	nomina
ingkab	nomina
insan	nomina
iring-iringan	nomina
irung	nomina
iskola	nomina
iteuk	nomina
itil	nomina
jagisuk	nomina
jagong	nomina
jajantung	nomina
jalma	nomina
jalmi	nomina
jalu	nomina
jama	nomina
jamang	nomina
jambe	nomina
jami	nomina
jamuju	nomina
janggot	nomina
jangjang	nomina
jangjawokan	nomina
jangji	nomina
jantung	nomina
japati	nomina
jarhiji	nomina
jaro	nomina
jawab	nomina
jawura	nomina
jejebir	nomina
jelema	nomina
jelma na	nomina
jempol	nomina
jentik	nomina
jeruk	nomina
jigong	nomina
jomantara	nomina
jubur	nomina
jukut	nomina
julang	nomina
Juma'ah	nomina
junti	nomina
jurig	nomina
juru hiber	nomina
jurung	nomina
kabayan	nomina
kabogoh	nomina
kaca	nomina
kacang mekah	nomina
kacang uci	nomina
kacapanon	nomina
kacasoca	nomina
kadal	nomina
kadangkawis	nomina
kadongdong	nomina
kadu	nomina
kahitutan	nomina
kahuruan	nomina
kai	nomina
kajang	nomina
kajang mastaka	nomina
kajineman	nomina
kaka	nomina
kakaban	nomina
kakang	nomina
kakarangge	nomina
kakasih	nomina
kalapa	nomina
kalbu	nomina
kaliandra	nomina
kalimah	nomina
kalong	nomina
kaluat	nomina
kalulusan	nomina
kaluron	nomina
kalenci	nomina
kampuh	nomina
kamungsil	nomina
kandatan	nomina
kang	nomina
kangkalung	nomina
kanjut	nomina
kantong	nomina
kanyeri	nomina
kaolahan	nomina
kapal hiber	nomina
kapal udara	nomina
kapamingpinan	nomina
kapiadi	nomina
kapiputra	nomina
kapirama	nomina
kapulaga	nomina
kapundung	nomina
kapungkur	nomina
karang	nomina
kararangge	nomina
karaton	nomina
karembong	nomina
karet kebo	nomina
karinget	nomina
karuhun	nomina
karunya	nomina
kasambi	nomina
kasay	nomina
kasintu	nomina
katapang	nomina
katuhu	nomina
katumbiri	nomina
kawajiban	nomina
kawalon	nomina
kawasa	nomina
kaway	nomina
kawih	nomina
kawijakan	nomina
kawijaksanaan	nomina
kawung	nomina
kecer	nomina
kedok	nomina
kedep	nomina
keliki	nomina
kelikih	nomina
keling	nomina
kembang	nomina
Kemis	nomina
kendi	nomina
kening	nomina
kentang	nomina
kerepus	nomina
ketu	nomina
keuneung	nomina
keureut	nomina
keusik	nomina
ki hiang	nomina
ki hujan	nomina
ki putri	nomina
kica-kica	nomina
kiceup	nomina
kideup	nomina
kidul	nomina
kiih	nomina
kilemo	nomina
kitri	nomina
kiwari	nomina
kokocoy	nomina
kokod	nomina
kolopak	nomina
konci	nomina
koneng gede	nomina
kongkorong	nomina
konyal	nomina
koneng	nomina
kopo	nomina
kopeah	nomina
koreng	nomina
kosambi	nomina
kotok	nomina
krenda	nomina
ku margi	nomina
ku sabab	nomina
kuda	nomina
kujang kijang	nomina
kuku	nomina
kukupu	nomina
kulawarga	nomina
kulit	nomina
kulit kai	nomina
kumeli	nomina
kumis	nomina
kunyuk	nomina
Kurea	nomina
kuris	nomina
kurupuk	nomina
kuwung-kuwung	nomina
kuya	nomina
kehed	nomina
kejo	nomina
kelek	nomina
kerod salawe	nomina
kesang	nomina
laga	nomina
lahir	nomina
lakon	nomina
lalaki	nomina
lalangse	nomina
lalay	nomina
lambey	nomina
lambut	nomina
lambe	nomina
lampah	nomina
lampuyang	nomina
lanceuk	nomina
lancingan	nomina
landepan	nomina
langgir	nomina
langgukan	nomina
langit	nomina
lanjang	nomina
latar	nomina
lauk	nomina
laut	nomina
lawon	nomina
lawet	nomina
layon	nomina
layung	nomina
lebak	nomina
lebu	nomina
lege	nomina
lelet	nomina
lembah	nomina
lembur	nomina
lendir	nomina
lentong	nomina
lepus	nomina
leuleueur	nomina
leungeun	nomina
leuweung	nomina
liang heunceut	nomina
lianna	nomina
Libanon	nomina
lilinieun	nomina
lima belas	nomina
limus	nomina
lingsu	nomina
lini	nomina
lisa	nomina
lisah	nomina
longser	nomina
lubuk	nomina
ludah	nomina
lumur	nomina
leho	nomina
lelepen	nomina
lember	nomina
lengkob	nomina
letah	nomina
makam	nomina
malati	nomina
malim	nomina
maling	nomina
mamang	nomina
mamas	nomina
manah	nomina
mang	nomina
manggu	nomina
mangkara	nomina
mangkukna	nomina
mantang	nomina
mantas	nomina
manten	nomina
manuk	nomina
margi	nomina
marurangkalih	nomina
masalih	nomina
masigit	nomina
mastaka	nomina
mata	nomina
matapoe	nomina
maung	nomina
medem	nomina
mega mendung	nomina
memek	nomina
menantu	nomina
mencek	nomina
meri	nomina
mertua	nomina
mimiti	nomina
minantu	nomina
minatu	nomina
Minggon	nomina
Minggu	nomina
minyak	nomina
mitoha	nomina
mojang	nomina
mokla	nomina
momok	nomina
monyet	nomina
muhara	nomina
mukla	nomina
munding	nomina
mungkal	nomina
murangkalih	nomina
muray	nomina
mega	nomina
memek	nomina
naga	nomina
nagara	nomina
nagari	nomina
nami	nomina
neng	nomina
ngaran	nomina
ngaruy	nomina
ngijih	nomina
nini	nomina
nu	nomina
nyungcung	nomina
nenen	nomina
obin	nomina
olahragi	nomina
olol	nomina
olet	nomina
ombroh	nomina
omong	nomina
opat belas	nomina
oray	nomina
orok	nomina
pabukon	nomina
padaharan	nomina
padog	nomina
padumukan	nomina
pagulingan	nomina
pagunungan	nomina
paha	nomina
pajaratan	nomina
pajuaran	nomina
palabuan udara	nomina
palabuhan	nomina
palajaran	nomina
palanggaran	nomina
palanggeran	nomina
palatih	nomina
palawangan	nomina
palih	nomina
palika	nomina
paling	nomina
palupuh	nomina
pamahaman	nomina
pamajikan	nomina
pamariksaan	nomina
pamariosan	nomina
pamasaran	nomina
pamatang	nomina
pamayang	nomina
pameget	nomina
pameunteu	nomina
pamikiran	nomina
pamilu	nomina
pamoloran	nomina
pamondokan	nomina
pameres	nomina
panangan	nomina
panaratas	nomina
panawaran	nomina
pancing	nomina
panday	nomina
pangambung	nomina
pangampih	nomina
panganggo	nomina
pangaos	nomina
pangaosan	nomina
pangapung	nomina
pangawulaan	nomina
pangcalikan	nomina
pangdiukan	nomina
pangersa	nomina
panget	nomina
pangheesan	nomina
panginang	nomina
panginten	nomina
pangira	nomina
pangkuleman	nomina
panglinggihan	nomina
pangpung	nomina
pangruru	nomina
pangsarean	nomina
pangwangunan	nomina
panitih	nomina
panon	nomina
panon poe	nomina
panonpoe	nomina
panto	nomina
panuding	nomina
pane	nomina
paok	nomina
papacang	nomina
papagah	nomina
papagon	nomina
papatah	nomina
papatong	nomina
parabot	nomina
parahu	nomina
paraji	nomina
parangi	nomina
pare	nomina
paribasa	nomina
parigi	nomina
pariksa	nomina
parios	nomina
paripaos	nomina
pariuk	nomina
parentah	nomina
pasarean	nomina
pasir	nomina
patarosan	nomina
patu	nomina
patuangan	nomina
payun	nomina
paesan	nomina
pedes	nomina
pekarang	nomina
pelat	nomina
pengker	nomina
pepelakan	nomina
perantawis	nomina
perhatosan	nomina
permios	nomina
perwata	nomina
pestol	nomina
peujit	nomina
peupeujeuh	nomina
peureuh	nomina
peuting	nomina
peuyeum	nomina
pianakan	nomina
picis	nomina
pinareup	nomina
pinareut	nomina
pingping	nomina
pipi	nomina
pira	nomina
pitandaklancaneun	nomina
piwarang	nomina
piwejang	nomina
piwulang	nomina
piwuruk	nomina
poleng	nomina
polo	nomina
pondok	nomina
poe	nomina
poe hareup	nomina
pramuseuweu	nomina
pucus	nomina
puhu	nomina
pulangan	nomina
pulo	nomina
pun aki	nomina
pun alo	nomina
pun biang	nomina
pun bibi	nomina
pun bojo	nomina
pun incu	nomina
pun lanceuk	nomina
pun nini	nomina
pun paman	nomina
punday	nomina
punduk	nomina
pundut	nomina
pungkur	nomina
puntang	nomina
punten	nomina
pupuk	nomina
pupur	nomina
purusa	nomina
puspa	nomina
pean	nomina
penta	nomina
pepeng	nomina
peso	nomina
radang	nomina
ragaji	nomina
raheut	nomina
raksukan	nomina
rama	nomina
ramo	nomina
baranang	nomina
ranca	nomina
randu	nomina
ranggon	nomina
rangrang	nomina
raramat	nomina
rarangan	nomina
rarasaan	nomina
rarawis	nomina
raray	nomina
rayi	nomina
Rebo	nomina
reog	nomina
rereng kujang	nomina
reueuk	nomina
reuma	nomina
reungit	nomina
riak	nomina
rohaka	nomina
rohangan	nomina
rorompok	nomina
ruhak	nomina
rumbah	nomina
rundayan	nomina
rungkun	nomina
runtah	nomina
ruruncang	nomina
rebu	nomina
regang	nomina
rema	nomina
renghap	nomina
reregan	nomina
sabakingking	nomina
sabda	nomina
sabet	nomina
sabudeureunna	nomina
sada	nomina
sadidinten	nomina
sagara	nomina
sajuta	nomina
sakola	nomina
salah sahiji	nomina
salah sawios	nomina
salaki	nomina
salapan belas	nomina
Salasa	nomina
salempay	nomina
salira	nomina
salju	nomina
salosin	nomina
samagaha	nomina
samak	nomina
samangka	nomina
sambetan	nomina
sametan	nomina
sami	nomina
samilyar	nomina
sampayan	nomina
sampean	nomina
sampeu	nomina
sampeureun	nomina
samping	nomina
sampiran	nomina
sampurasun	nomina
sampean	nomina
sanggar	nomina
sanggem	nomina
sangko	nomina
sangketan	nomina
sangu	nomina
sapi	nomina
Saptu	nomina
sapuluh rebu	nomina
sarah	nomina
saratus	nomina
saratus rebu	nomina
saraya	nomina
sarundeng	nomina
sarung cagak	nomina
sarebu	nomina
sasak	nomina
sasalad	nomina
sasatoan	nomina
sasatron	nomina
sasih	nomina
sato	nomina
saung	nomina
saur	nomina
sawah	nomina
sawan	nomina
sekar	nomina
selong	nomina
sendok	nomina
sengker	nomina
Senen	nomina
sereh	nomina
sesepeun	nomina
seuneu	nomina
seuweu	nomina
seuweu-siwi	nomina
siang	nomina
siduk	nomina
siksik	nomina
siku	nomina
silalatu	nomina
siluman	nomina
sima	nomina
simabdi	nomina
simbar	nomina
simbut	nomina
simeut	nomina
singkah	nomina
singkir	nomina
sinjang	nomina
sirah	nomina
sirit	nomina
sisikilir	nomina
sisir	nomina
situ	nomina
soanten	nomina
sobong	nomina
soca	nomina
somah	nomina
sompral	nomina
sora	nomina
sosi	nomina
sosog	nomina
srangenge	nomina
suanten	nomina
subaya	nomina
suhun	nomina
suhunan	nomina
suku	nomina
sulbi	nomina
suluh	nomina
sumber	nomina
sungkelang	nomina
sungut	nomina
surat	nomina
surundeng	nomina
susu	nomina
susuhunan	nomina
suwagi	nomina
serang	nomina
sewang	nomina
taar	nomina
tabe	nomina
tabeat	nomina
tai kotok	nomina
tajuk	nomina
takokak	nomina
taksi	nomina
taktak	nomina
talapak	nomina
talapak suku	nomina
talupuh	nomina
tampekan	nomina
tanaga	nomina
tanaga jero	nomina
tanagi	nomina
tanagi lebet	nomina
tanduk	nomina
taneuh	nomina
tangange	nomina
tanggay	nomina
tangkal	nomina
tangkepan	nomina
tangkurak	nomina
tanya	nomina
taraju	nomina
tarang	nomina
taros	nomina
tarumpah	nomina
tasma	nomina
tatangga	nomina
tatu	nomina
taun	nomina
tawis asta	nomina
teda	nomina
tekokak	nomina
tekotok	nomina
teku	nomina
telur	nomina
tengen	nomina
tenggek	nomina
tenggerok	nomina
tenggerokan	nomina
tepas	nomina
teteh	nomina
teteken	nomina
tetengger	nomina
teundeun	nomina
tiasa	nomina
tihang kopeah	nomina
tihul	nomina
tijah	nomina
tikoro	nomina
tikotok	nomina
tikukur	nomina
tilad	nomina
tilas	nomina
tilok	nomina
tilu belas	nomina
timba	nomina
timbal	nomina
timbalan	nomina
timbel	nomina
tineung	nomina
titah	nomina
titihan	nomina
tiung	nomina
tiwu	nomina
tonggong	nomina
topi	nomina
torogan	nomina
toel	nomina
tuang ibu	nomina
tuang istri	nomina
tuang rama	nomina
tuang rayi	nomina
tudung	nomina
tujuh belas	nomina
tujuh ratus	nomina
tukang	nomina
tukangeun	nomina
tulad	nomina
tulang	nomina
tumblegan	nomina
tumbung	nomina
tunduh	nomina
tunggangeun	nomina
tunggir	nomina
tungkak	nomina
tungtung	nomina
turuh	nomina
tutunggul	nomina
tutut	nomina
tuur	nomina
teh	nomina
tekas	nomina
tekotok	nomina
tembal	nomina
tere	nomina
teteh	nomina
tetesan	nomina
ucing	nomina
udel	nomina
udud	nomina
udul	nomina
ules	nomina
umbel	nomina
umur	nomina
uncal	nomina
unggel	nomina
uni	nomina
untap	nomina
urang	nomina
urug	nomina
urut	nomina
useup	nomina
uteuk	nomina
utun	nomina
utun inji	nomina
uyah	nomina
uyut	nomina
wadah	nomina
waduk	nomina
wahangan	nomina
wahanten	nomina
waktos	nomina
waler	nomina
walirang	nomina
waliwis	nomina
walon	nomina
walungan	nomina
wanara	nomina
wanceuy	nomina
wanci	nomina
wangkid	nomina
wangsit	nomina
wanoja	nomina
waos	nomina
warga	nomina
wargi	nomina
warsih	nomina
warta	nomina
wartos	nomina
waruga	nomina
warung	nomina
wastra	nomina
wastra Nusantara	nomina
wates	nomina
wayah	nomina
wayang	nomina
wedak	nomina
wedidang	nomina
welas	nomina
wengi	nomina
wewetengan	nomina
wisesa	nomina
wuwung	nomina
yasa	nomina
yuswa	nomina
ea	nomina
ejrahan	nomina
elang	nomina
elmu	nomina
empang	nomina
es	nomina
ese	nomina
ewang	nomina
ewe	nomina
dalapan	numeralia
dua	numeralia
dua likur	numeralia
duaan	numeralia
enol	numeralia
genep	numeralia
genep ratus	numeralia
hiji	numeralia
kabeh	numeralia
kalih	numeralia
lima	numeralia
opat	numeralia
sababaraha	numeralia
sabelas	numeralia
sadaya	numeralia
saketi	numeralia
sakodi	numeralia
sakumna	numeralia
sakur	numeralia
salaksa	numeralia
salapan	numeralia
salawe	numeralia
salayan	numeralia
salikur	numeralia
saniskanten	numeralia
saniskara	numeralia
sapuluh	numeralia
saraju	numeralia
sawatara	numeralia
sawatawis	numeralia
sawidak	numeralia
sawios	numeralia
saese	numeralia
selapan	numeralia
siki	numeralia
sugri	numeralia
talu	numeralia
tilu	numeralia
tilu likur	numeralia
tujuh	numeralia
angot	partikel
antep	partikel
atuh	partikel
cuang	partikel
dawuh dalem	partikel
encan	partikel
enya	partikel
hageuy	partikel
heueuh	partikel
jih	partikel
kalagian	partikel
komo	partikel
laju	partikel
mantak	partikel
masing	partikel
matak	partikel
mesing	partikel
mesingkeun	partikel
misah	partikel
muhun	partikel
najan	partikel
nam	partikel
nyaeta	partikel
sabot	partikel
samentawis	partikel
sanajan	partikel
sanaos	partikel
sinanteneun	partikel
sinarieun	partikel
soteh	partikel
soten	partikel
soteh	partikel
soten	partikel
sumawona	partikel
sumawonten	partikel
sumuhun	partikel
sumuhun dawuh	partikel
teh	partikel
upadi	partikel
dang	preposisi
dina	preposisi
doang	preposisi
eujeung	preposisi
geusan	preposisi
ka	preposisi
kahaturan	preposisi
kajabi	preposisi
kalih	preposisi
kanggo	preposisi
kangge	preposisi
kirang	preposisi
ku	preposisi
nepikeun	preposisi
pikeun	preposisi
saprak	preposisi
ti sabet	preposisi
ti sabot	preposisi
aa	pronomina
aang	pronomina
abah	pronomina
abdi	pronomina
abdi dalem	pronomina
abdi gusti	pronomina
abdi sadaya	pronomina
abi	pronomina
aing	pronomina
ama	pronomina
andika	pronomina
anjeun	pronomina
anjeunna	pronomina
apa	pronomina
aranjeun	pronomina
aranjeunna	pronomina
arurang	pronomina
babeh	pronomina
cuang	pronomina
dampal dalem	pronomina
dampal gamparan	pronomina
dampal gusti	pronomina
dararia	pronomina
daria	pronomina
di dia	pronomina
di dieu	pronomina
di dinya	pronomina
di ditu	pronomina
di endi	pronomina
di manten	pronomina
di mendi	pronomina
dia	pronomina
didieu	pronomina
didinya	pronomina
dieu	pronomina
dinih	pronomina
eta	pronomina
gamparan	pronomina
haridep	pronomina
hidep	pronomina
hidep sarerea	pronomina
ieu	pronomina
ilaing	pronomina
inyana	pronomina
jidaeud	pronomina
juragan	pronomina
ka endi	pronomina
ka mana	pronomina
ka mendi	pronomina
kami	pronomina
kandi	pronomina
karita	pronomina
kieu	pronomina
kita	pronomina
kuring	pronomina
mamah	pronomina
kamana	pronomina
mantenna	pronomina
maneh	pronomina
manehna	pronomina
maraneh	pronomina
maranehna	pronomina
nyana	pronomina
nyaneh	pronomina
nyanehna	pronomina
nyaraneh	pronomina
nyinaon	pronomina
palih dieu	pronomina
palih ditu	pronomina
pribados	pronomina
pun bapa	pronomina
sabaraha	pronomina
saha	pronomina
salira	pronomina
sanaon	pronomina
sararia	pronomina
saria	pronomina
sia	pronomina
silaing	pronomina
sim kuring	pronomina
sim kuring sadaya	pronomina
ti endi	pronomina
ti mendi	pronomina
tindi	pronomina
urang	pronomina
yeuh	pronomina
eta	pronomina
abdas	verba
acan	verba
adeg	verba
adeuk	verba
ajrug-ajrugan	verba
ajenan	verba
alung	verba
alungkeun	verba
ambek	verba
ambek-ambekan	verba
ambeh	verba
amring	verba
andika	verba
angir	verba
angkat	verba
angkir	verba
angob	verba
anten	verba
antepkeun	verba
anti	verba
antos	verba
aos	verba
apal	verba
apung	verba
arot	verba
asta	verba
asup	verba
aya	verba
ayak	verba
babacot	verba
babangus	verba
babarengan	verba
babet	verba
bacok	verba
badami	verba
badanten	verba
bade	verba
bagea	verba
bahas	verba
balanja	verba
balawanan	verba
balayar	verba
balem	verba
balik	verba
baledog	verba
bancang	verba
banjat	verba
banjut	verba
bantos	verba
bantun	verba
banyol	verba
barang hakan	verba
barempag	verba
barempug	verba
bawa	verba
beku	verba
belah	verba
berik	verba
beu	verba
beubeut	verba
beulah	verba
beuleum	verba
beuli	verba
beulit	verba
beunang	verba
beunta	verba
bijil	verba
bingbar	verba
bintrang	verba
bitu	verba
bobo	verba
bobos	verba
boga	verba
bogoh	verba
borojol	verba
buat	verba
bubar	verba
bubuang	verba
bubujeng	verba
bubulucun	verba
buka	verba
bunuh	verba
buru	verba
butek	verba
beak	verba
belok	verba
bere	verba
caah	verba
caduk	verba
calik	verba
candak	verba
candakara	verba
cangking	verba
cekel	verba
cengkat	verba
cepeng	verba
ceurik	verba
cici	verba
cicing	verba
citak	verba
ciwit	verba
cokot	verba
coret	verba
cunduk	verba
curat-coret	verba
daang	verba
dadaharan	verba
dago	verba
dahar	verba
damel	verba
dangdan	verba
dangdos	verba
dangu	verba
dapang	verba
dapur	verba
dasta	verba
datang	verba
dauk	verba
daek	verba
dederek	verba
dengar	verba
dengekeun	verba
deuleu	verba
di handap	verba
di jero	verba
di luhur	verba
dibireungeuh	verba
dicolok	verba
dideuleu	verba
digentra	verba
digentraan	verba
digero	verba
digeroan	verba
dihakan	verba
mendilak	verba
Dimiangkeun	verba
dioragkeun	verba
dipohokeun	verba
disampeur	verba
disampeuran	verba
disampeurkeun	verba
disingkahkeun	verba
ditambul	verba
ditempo	verba
ditingal	verba
ditingali	verba
ditoel	verba
diuk	verba
dongkap	verba
dongkip	verba
mendongsok	verba
dugi	verba
dumuk	verba
durukan	verba
denge	verba
emam	verba
mengembarkan	verba
emuh	verba
engab	verba
engapan	verba
engeuh	verba
eueu	verba
eueut	verba
eureun	verba
euweuh	verba
gableg	verba
gacong	verba
gadeg	verba
gaduh	verba
gadur	verba
galeuh	verba
galungan	verba
gandek	verba
ganti	verba
garing	verba
garo	verba
gawe	verba
gebug	verba
gelut	verba
gendir	verba
gentos	verba
gering	verba
gimbar	verba
gingsir	verba
gosok	verba
guang	verba
mengguar	verba
gubug	verba
gugah	verba
gugurah	verba
guguru	verba
gumujeng	verba
gusar	verba
guyon	verba
gegel	verba
hamuay	verba
hanjat	verba
haturan	verba
heuay	verba
heumpas	verba
heureuy	verba
hiber	verba
hidup	verba
hilang	verba
hilap	verba
hina	verba
hitut	verba
hudang	verba
hujan	verba
hurung	verba
hees	verba
iam	verba
ibak	verba
ibing	verba
ical	verba
icing	verba
igel	verba
imut	verba
indit	verba
injeuman	verba
inum	verba
itung	verba
jajablog	verba
jajap	verba
jalajat	verba
jangkor	verba
janten	verba
jarumat	verba
jatukrami	verba
jedog	verba
jedes	verba
jeger	verba
jengkar	verba
jeueung	verba
jeuleu	verba
jual	verba
juar	verba
kabantos	verba
kabeuratan	verba
kabobosan	verba
kagungan	verba
kahampangan	verba
kahuruan	verba
kajangjanan	verba
kajeuleu	verba
kali	verba
kaluar	verba
kamashur	verba
kamerkaan	verba
kanceuh	verba
kandung	verba
kaput	verba
karugrag	verba
kasawat	verba
kasempetan	verba
kaseuit	verba
kasohor	verba
katelah	verba
katimu	verba
kawin	verba
kawon	verba
kekemu	verba
kelahi	verba
kenal	verba
kenyot	verba
kersa	verba
keuna	verba
keur	verba
kiih	verba
kintun	verba
kirim	verba
kocor	verba
kojor	verba
kokocok	verba
kokotor	verba
kujamas	verba
kukumbah piring	verba
kulem	verba
kuping	verba
kuramas	verba
keok	verba
labuh	verba
laip	verba
lamar	verba
lamotan	verba
landep	verba
landong	verba
langkung	verba
lebet	verba
lelebok	verba
leleson	verba
lenggah	verba
leueut	verba
leumpang	verba
leungit	verba
linggih	verba
liren	verba
liwat	verba
lokika	verba
lolodok	verba
luga	verba
lugay	verba
lumangsung	verba
lungsur	verba
maca	verba
macangkrama	verba
macangkrami	verba
madang	verba
maju	verba
malire	verba
mamam	verba
mangkon	verba
mangku	verba
mangrupikeun	verba
mantak	verba
mantog	verba
maot	verba
mapah	verba
maparinan	verba
mapatahan	verba
matak	verba
matuh	verba
mawa	verba
maehan	verba
maen	verba
medut	verba
mejus	verba
melong	verba
merhatoskeun	verba
meser	verba
metot	verba
meunang	verba
miang	verba
miara	verba
miceun	verba
miharep	verba
mikanyaho	verba
mikir	verba
mindel	verba
mintonkeun	verba
mios	verba
miraos	verba
mireng	verba
mireungeuh	verba
mirosea	verba
miwejang	verba
modar	verba
modol	verba
molongo	verba
molor	verba
mondok	verba
moro	verba
mulang	verba
mulih	verba
mundur	verba
mundut	verba
muntang	verba
murag	verba
mengkol	verba
menta	verba
mesem	verba
nambul	verba
nambut	verba
nambutkeun	verba
nangtung	verba
nanya	verba
narepkeun	verba
naros	verba
neda	verba
nelasan	verba
nembang	verba
nempo	verba
netelakeun	verba
netepan	verba
neuleu	verba
ngabala	verba
ngabandungan	verba
ngabangus	verba
ngabanjut	verba
ngabantun	verba
ngabaranang	verba
ngaberik	verba
ngabuburit	verba
ngacapluk	verba
ngacaprak	verba
ngadagoan	verba
ngadahup	verba
ngadastakeun	verba
ngadawuh	verba
ngadederek	verba
ngadeg	verba
ngadorong	verba
ngadu biru	verba
ngaduruk	verba
ngadenge	verba
ngadeoh	verba
ngagali	verba
ngagarap	verba
ngageuingkeun	verba
ngagodin	verba
ngagosok	verba
ngagubug	verba
ngagugu	verba
ngahakan	verba
ngahaleuang	verba
ngahaleuangkeun	verba
ngahapus	verba
ngaheuyeuk	verba
ngaheuyeuk dayeuh	verba
ngahuma	verba
ngajadikeun	verba
ngajaga	verba
ngajar	verba
ngajayak	verba
ngajedog	verba
ngajomantara	verba
ngajuru	verba
ngala	verba
ngalagragkeun	verba
ngalahir	verba
ngalahun	verba
ngalalaca	verba
ngalandep	verba
ngalawan	verba
ngalayad	verba
ngalebok	verba
ngalibetkeun	verba
ngalicikan	verba
ngalongok	verba
ngaludah	verba
ngaludang	verba
ngaleler	verba
ngamanah	verba
ngamangpaatkeun	verba
ngambeu	verba
ngandika	verba
ngandung	verba
ngangluh	verba
nganti	verba
ngantos	verba
ngantosan	verba
ngantunkeun	verba
ngapak	verba
ngapilainkeun	verba
ngapung	verba
ngaput	verba
ngaraketkeun	verba
ngaraos	verba
ngaregepkeun	verba
ngareungeu	verba
ngariung	verba
Ngaronjatkeun	verba
ngarenghap	verba
ngaso	verba
ngasta	verba
ngawasuh	verba
ngawejang	verba
ngawih	verba
ngawonan	verba
ngawulang	verba
ngawuruk	verba
ngayakeun	verba
Ngebralkeun	verba
ngecaprak	verba
ngedeng	verba
ngendog	verba
ngenen	verba
ngeuyeuk	verba
ngicalkeun	verba
nginang	verba
nginjeum	verba
nginjeumkeun	verba
ngising	verba
ngobor	verba
ngojay	verba
ngomong	verba
ngoprek	verba
ngower	verba
ngudag	verba
ngumbah	verba
ngunjukkeun	verba
ngebog	verba
ngegel	verba
ngelehan	verba
nikah	verba
nimbalan	verba
ningal	verba
ningali	verba
niron	verba
nitih	verba
niup	verba
niwas	verba
notod	verba
nuju	verba
nungguan	verba
nyacat	verba
nyaho	verba
nyampak	verba
nyampeur	verba
nyampeurkeun	verba
nyamuni	verba
nyandak	verba
nyaneut	verba
nyanggem	verba
nyapukeun	verba
nyarios	verba
nyarita	verba
nyatu	verba
nyaur	verba
nyelesep	verba
nyembahkeun	verba
nyeuleu	verba
nyeuseuh	verba
nyeuseup	verba
nyiduh	verba
nyoco	verba
nyokot	verba
nyondong	verba
nyonyo	verba
nyuhunkeun	verba
nyukcruk	verba
nyusu	verba
nyutat	verba
nyeker	verba
nenen	verba
obo	verba
ocon	verba
ojolan	verba
olahragi	verba
olohok	verba
ondang	verba
paamprok	verba
paben	verba
padu	verba
paduli	verba
pair	verba
palastra	verba
palid	verba
panambut	verba
pandakawan	verba
panginjeum	verba
pangira	verba
papah	verba
papang	verba
papanggih	verba
paparin	verba
papung	verba
parios	verba
pasea	verba
pasih	verba
patepang	verba
patepung	verba
patimu	verba
pawon	verba
paeh	verba
paehan	verba
pependak	verba
peper	verba
percanten	verba
percaya	verba
perelu	verba
perlaya	verba
peryogi	verba
peureut	verba
pikir	verba
pineuh	verba
podaran	verba
podol	verba
poho	verba
potong	verba
priyogi	verba
pucunghul	verba
pukul	verba
pupus	verba
purun	verba
peser	verba
raat	verba
ragrag	verba
rampung	verba
baranang	verba
rawuh	verba
regep	verba
rekep	verba
resep	verba
reungeu	verba
reungeuh	verba
reureuh	verba
root	verba
rungsing	verba
ruru	verba
rendengan	verba
saluyu	verba
sambeang	verba
sampeur	verba
sampeuran	verba
sampeurkeun	verba
sanggem	verba
sangkan	verba
sangki	verba
sapagodos	verba
sapertos	verba
sapuk	verba
sare	verba
sare	verba
sasalaman	verba
sasanggem	verba
sasarengan	verba
sasarean	verba
sasauran	verba
satuju	verba
sawala	verba
menyawer	verba
sayogi	verba
senggol	verba
serat	verba
sesep	verba
seueul	verba
seungeut	verba
seuri	verba
seuseuh	verba
seuseup	verba
siduru	verba
sideang	verba
solat	verba
sompral	verba
sudi	verba
sumping	verba
supados	verba
supanten	verba
supaya	verba
suruput	verba
seseleketan	verba
seep	verba
tahu	verba
tai	verba
talab	verba
tamba	verba
tambutan	verba
tangtung	verba
tapelkeun	verba
tarep	verba
tatanggi	verba
tataranjang	verba
tatih	verba
taya	verba
teke	verba
telasan	verba
tempo	verba
tepi	verba
terang	verba
teu aya	verba
teu damang	verba
teu kosi	verba
teukteuk	verba
teunggeul	verba
teuteup	verba
tincak	verba
tingal	verba
tingali	verba
tipagut	verba
tiron	verba
titih	verba
tiup	verba
tojos	verba
top	verba
tuang	verba
tulis	verba
tuluykeun	verba
tumanya	verba
tumaros	verba
tumenga	verba
tumpak	verba
tunggang	verba
tunggu	verba
tuntun	verba
turun	verba
tenjo	verba
tetek	verba
ubar	verba
ucuseun	verba
udur	verba
ugah	verba
uih	verba
uihan	verba
ujung	verba
ukeun	verba
ulabon	verba
ulaheun	verba
ulem	verba
mengulik	verba
ulin	verba
uninga	verba
unjuk	verba
mengunun	verba
utah	verba
W	verba
wadul	verba
wangsul	verba
wanoh	verba
wawuh	verba
wentis	verba
weruh	verba
wincik	verba
wiwis	verba
wudu	verba
eling	verba
eleh	verba
erep	verba
etang	verba
